ActicityInstID                	撤销到该活动实例ID
ActivityID                    	活动ID
ActivityInsID                 	活动实例ID
ActivityInstID                	活动实例ID
ActualInstallDate             	实际安装完成时间
ActualPauseDate               	实际暂停时间
AllArea                       	工程总面积（平方米）
AppID                         	appid
ApplicationID                 	应用ID
ApproveStatus                 	审批状态
AssistType                    	辅助人员类型
BaseURL                       	视频查看地址
BuildScale                    	建设规模
BussIF                        	业务实现接口
BussLicCode                   	工商营业执照注册号
ButtonID                      	按钮ID
ButtonName                    	按钮名称
ButtonType                    	按钮类型
CertCode                      	证件号码
CertType                      	证件类型
CheckNum                      	验证码（登录密码与验证码二选一）
CtrlDestType                  	控制目标类型
CtrlDestValue                 	控制目标值
CtrlObjType                   	控制对象类型
CtrlObjValue                  	控制对象值
CtrlOperation                 	控制操作
DBPID                         	流程定义主键
DeclareRemark                 	申报备注
DestUserID                    	被授权角色的用户ID
DevIDs                        	设备主键列表,半角逗号间隔
Draft                         	是否保存草稿
Duty                          	职务
Email                         	电子邮箱
EstablishDate                 	成立日期
FileUrl                       	监管系统上传文件url
FirstAllowQCDate              	首次批准资质资格日期
FormData                      	表单定义数据
FormID                        	表单ID
FormName                      	表单名称
FromAppID                     	最后一次更新的来源appid
ID                            	主键ID
IDCode                        	证件号码
IDListValid                   	业务属性是否返回
IDType                        	证件类型
InstallRemark                 	安装备注
IsLeaf                        	是否叶子：0：否1：是
IsLock                        	是否锁定
IsMainQC                      	是否主项资质
IsPass                        	0：审核不通过1：审核通过
IsSaveHis                     	是否保存历史
IsVisible                     	是否可见0：不可见1：可见
IssuingAuthority              	发证机关
IssuingDate                   	发证日期
ItemID                        	单位工程ID
LPCode                        	法定代表人证件号码
LPCodeType                    	法定代表人证件类型
LPName                        	法定代表人姓名
MaintainRemark                	报修备注
MenuBtnID                     	菜单关联按钮ID
MenuID                        	菜单ID
MenuName                      	菜单名称
MenuOrder                     	菜单展示顺序
MenuUrl                       	菜单URL
Name                          	姓名
OPJobTitle                    	企业负责人职称
OPName                        	企业负责人姓名
OPPosition                    	企业负责人职务
OfficePhone                   	办公电话
Operation                     	1：分配角色2：取消角色3：授权角色4：取消授权
OperatorFileUrl               	运营商返回文件url
OrgAddress                    	机构地址
OrgCode                       	机构代码（统一社会信用代码）
OrgID                         	机构UUID
OrgName                       	机构名称
OrgOfficePhone                	办公电话
OrgProvince                   	省
OrgRegType                    	企业登记注册类型
OrgType                       	机构类型
PTelPhone                     	项目负责人电话
Params                        	Json参数列表
Password                      	登录密码（MD5加密）
PauseRemark                   	暂停备注
PersonID                      	人员信息UUID
PhoneNum                      	手机号码
Principal                     	项目负责人
ProID                         	项目主键
ProMngIDCode                  	项目经理证件号码
ProMngName                    	项目经理姓名
ProMngPhone                   	项目经理联系电话
ProcessID                     	ACTIVITY流程ID
ProcessInsID                  	流程实例ID
ProcessInstID                 	流程主键UUID
ProcessName                   	流程名称
QCCFCode                      	证书编号
QCCFStatus                    	证书状态
QCCFType                      	资质资格类型
QCSubType                     	资质资格序列
QCType                        	资质资格类型
RMBID                         	责任主体主键
RealName                      	姓名
Reason                        	退回理由
RegCertCode                   	注册证书编号
RegCode                       	项目施工负责人（项目经理）执业资格证书号
RegLevel                      	注册等级
RegSealCode                   	注册印章号
RegType                       	注册类型
RegValidDate                  	注册有效期
RemoveRemark                  	拆除备注
RoleID                        	角色ID
RoleIDs                       	半角逗号间隔的角色ID列表
RoleName                      	角色名称
RollBackStatus                	回滚到指定的状态
Route                         	路由
SLValidFrom                   	安全许可有效期自
Secret                        	授权码
SecurityLicCode               	安全许可证编号
SeqNo                         	顺序编号
ServiceOperator               	服务运营商
Sex                           	性别
Status                        	职业资格状态
TelPhone                      	手机号（手机号与用户名二选一）
Timestamp                     	时间戳
Token                         	秘钥secret加密后的鉴权key
Type                          	类型0：登录验证码1：注册验证码
UserID                        	用户ID
UserName                      	用户名
ValidToDate                   	有效期到
Way                           	招标方式
WinDate                       	中标日期
WinNoteCode                   	施工中标通知编号
WinOrgName                    	中标单位名称
WinPrice                      	中标金额（万元）
XML                           	流程定义BPMN数据
actualInstallDate             	实际安装完成时间
actualMaintainDate            	实际维护完成时间
actualPauseDate               	实际暂停时间
actualRecoverDate             	实际恢复时间
actualRemoveDate              	实际拆除完成时间
agreeRemoveDate               	审核通过时间
appId                         	用户最后一次更新的来源appid
badDevId                      	故障的设备id，多个逗号间隔
badEnvironmentalDevId         	故障的设备id，多个逗号间隔
corpCode                      	申报施工单位组织机构代码
corpName                      	申报施工单位名称
dcPK                          	申报Id
declareDate                   	申报时间
declareRemark                 	申报备注
detectProId                   	远程监控系统项目主键
devFlowState                  	流程状态
devId                         	设备编号
devInstalPlace                	安装位置
devName                       	设备名称
devPlayConfig                 	全景成像测量摄像机设备运行参数配置
devType                       	设备类型
devUnitType                   	设备型号
devUnittype                   	设备型号
endDate                       	结束时间
highDev                       	设备高程(mm)
highTargeted                  	测量点高程(mm)
installRemark                 	安装备注
itemId                        	单位工程ID
laserIntensity                	测量点激光光强
laserRangingType              	激光测距型号(安全型激光)
latDev                        	设备纬度(精度7位小数)
latTargeted                   	测量点纬度(精度7位小数)
levelAngle                    	水平角度
lngDev                        	设备经度(精度7位小数)
lngTargeted                   	测量点经度(精度7位小数)
maintainDate                  	报修时间
maintainDescribe              	维护说明
maintainRemark                	报修备注
obd                           	测量点激光距离(mm)
operatorFileUrl               	运营商文件
oprDcPK                       	互联互通业务Id
oprId                         	监管系统id
oprType                       	业务类型
opticalFrequency1             	光波频率1(MHz)
opticalFrequency2             	光波频率2(MHz)
opticalFrequency3             	光波频率3(MHz)
passDate                      	审核通过时间
pauseDeclareDate              	暂停申请时间
pauseRemark                   	暂停备注
planRemoveDate                	计划拆除完成时间
prjName                       	项目名称
proId                         	项目主键
provincePrjNum                	项目省代码，审核通过的才有数据
reason                        	故障原因
recoverDeclareDate            	恢复申请时间
recoverRemark                 	恢复备注
remark                        	备注
removeDeclareDate             	拆除申报时间
removeDescribe                	拆除说明
removeRemark                  	拆除备注
serviceOperator               	服务运营商
staDate                       	申请时间
topoId                        	VSAP设备拓扑ID
verticalAngle                 	垂直角度
videoEnvironmentalStatus      	项目的环境侦测设备的故障状态
videoStatus                   	项目的所有设备的故障状态